{
	"width": 9,
	"height": 10,
	"offset": "1,1,1",
	"comboEnable": "false",
	"maxTypes": "7",
	"layer": [
		[
			[0, 0, 0, 0, 0, 0, 0, 0, 0],
			[0, 0, 0, 0, 0, 0, 0, 0, 0],
			[0, 1, 1, 1, 1, 1, 1, 1, 0],
			[0, 1, 1, 1, 1, 1, 1, 1, 0],
			[0, 1, 1, 1, 0, 1, 1, 1, 0],
			[0, 1, 1, 1, 0, 1, 1, 1, 0],
			[0, 1, 1, 1, 1, 1, 1, 1, 0],
			[0, 1, 1, 1, 1, 1, 1, 1, 0],
			[0, 0, 0, 0, 0, 0, 0, 0, 0],
			[0, 0, 0, 0, 0, 0, 0, 0, 0]
		],
		[
			[0, 0, 0, 0, 0, 0, 0, 0, 0],
			[0, 0, 0, 0, 0, 0, 0, 0, 0],
			[0, 0, 0, 0, 0, 0, 0, 0, 0],
			[0, 1, 1, 1, 1, 1, 1, 0, 0],
			[0, 1, 1, 1, 1, 1, 1, 0, 0],
			[0, 1, 1, 1, 1, 1, 1, 0, 0],
			[0, 1, 1, 1, 1, 1, 1, 0, 0],
			[0, 1, 1, 1, 1, 1, 1, 0, 0],
			[0, 0, 0, 0, 0, 0, 0, 0, 0],
			[0, 0, 0, 0, 0, 0, 0, 0, 0]
		],
		[
			[0, 0, 0, 0, 0, 0, 0, 0, 0],
			[0, 0, 0, 0, 0, 0, 0, 0, 0],
			[0, 0, 0, 0, 0, 0, 0, 0, 0],
			[0, 0, 1, 1, 1, 1, 1, 0, 0],
			[0, 0, 1, 1, 1, 1, 1, 0, 0],
			[0, 0, 1, 1, 1, 1, 1, 0, 0],
			[0, 0, 1, 1, 1, 1, 1, 0, 0],
			[0, 0, 0, 0, 0, 0, 0, 0, 0],
			[0, 0, 0, 0, 0, 0, 0, 0, 0],
			[0, 0, 0, 0, 0, 0, 0, 0, 0]
		]
	],
	"iconnums": 90
}