{
	"width": 9,
	"height": 10,
	"offset": "0,1,1",
	"layer": [
		[
			[0, 0, 0, 0, 0, 0, 0, 0, 0],
			[0, 0, 0, 0, 0, 0, 0, 0, 0],
			[0, 0, 1, 1, 1, 1, 1, 0, 0],
			[0, 0, 1, 1, 1, 1, 1, 0, 0],
			[0, 0, 1, 1, 1, 1, 1, 0, 0],
			[0, 0, 1, 1, 1, 1, 1, 0, 0],
			[0, 0, 1, 1, 1, 1, 1, 0, 0],
			[0, 0, 0, 0, 0, 0, 0, 0, 0],
			[0, 0, 0, 0, 0, 0, 0, 0, 0],
			[0, 0, 0, 0, 0, 0, 0, 0, 0]
		],
		[
			[0, 0, 0, 0, 0, 0, 0, 0, 0],
			[0, 0, 0, 0, 0, 0, 0, 0, 0],
			[0, 0, 1, 1, 1, 1, 1, 0, 0],
			[0, 0, 1, 1, 1, 1, 1, 0, 0],
			[0, 0, 1, 1, 0, 1, 1, 0, 0],
			[0, 0, 1, 1, 1, 1, 1, 0, 0],
			[0, 0, 1, 1, 1, 1, 1, 0, 0],
			[0, 0, 0, 0, 0, 0, 0, 0, 0],
			[0, 0, 0, 0, 0, 0, 0, 0, 0],
			[0, 0, 0, 0, 0, 0, 0, 0, 0]
		],
		[
			[0, 0, 0, 0, 0, 0, 0, 0, 0],
			[0, 0, 0, 0, 0, 0, 0, 0, 0],
			[0, 0, 1, 1, 1, 1, 1, 0, 0],
			[0, 0, 1, 1, 1, 1, 1, 0, 0],
			[0, 0, 1, 1, 1, 1, 1, 0, 0],
			[0, 0, 1, 1, 1, 1, 1, 0, 0],
			[0, 0, 1, 1, 1, 1, 1, 0, 0],
			[0, 0, 0, 0, 0, 0, 0, 0, 0],
			[0, 0, 0, 0, 0, 0, 0, 0, 0],
			[0, 0, 0, 0, 0, 0, 0, 0, 0]
		],
		[
			[0, 0, 0, 0, 0, 0, 0, 0, 0],
			[0, 0, 0, 0, 0, 0, 0, 0, 0],
			[0, 0, 1, 1, 1, 1, 1, 0, 0],
			[0, 0, 1, 1, 1, 1, 1, 0, 0],
			[0, 0, 1, 1, 0, 1, 1, 0, 0],
			[0, 0, 1, 1, 1, 1, 1, 0, 0],
			[0, 0, 1, 1, 1, 1, 1, 0, 0],
			[0, 0, 0, 0, 0, 0, 0, 0, 0],
			[0, 0, 0, 0, 0, 0, 0, 0, 0],
			[0, 0, 0, 0, 0, 0, 0, 0, 0]
		],
		[
			[0, 0, 0, 0, 0, 0, 0, 0, 0],
			[0, 0, 0, 0, 0, 0, 0, 0, 0],
			[0, 0, 1, 1, 1, 1, 1, 0, 0],
			[0, 0, 1, 1, 1, 1, 1, 0, 0],
			[0, 0, 1, 1, 1, 1, 1, 0, 0],
			[0, 0, 1, 1, 1, 1, 1, 0, 0],
			[0, 0, 1, 1, 1, 1, 1, 0, 0],
			[0, 0, 0, 0, 0, 0, 0, 0, 0],
			[0, 0, 0, 0, 0, 0, 0, 0, 0],
			[0, 0, 0, 0, 0, 0, 0, 0, 0]
		]
	],
	"iconnums": 123
}